1921
1111111111111111111
1000000000000000001
1010110111110110101
1010110100010110101
1010000101010000101
1011010101010101101
1101111101011111011
1100010000000100011
0001010110110101000
1111000100010001111
0001010111110101000
1100010000000100011
1101011101011101011
1001000001000001001
1011110101010111101
1000000100010000001
1011010111110101101
1010010000000100101
1010111101011110101
1000000001000000021
1111111111111111111
11



