10 20
1 1 1 1 1 1 1 1 1 1 1 1 1 1 1 1 1 1 1 1
1 2 2 2 2 1 2 1 3 2 2 2 1 2 2 2 2 1 2 1
1 1 1 2 2 2 2 1 2 2 2 2 1 1 1 2 2 2 2 1
1 2 2 2 1 2 2 1 2 2 2 2 1 2 2 2 1 2 2 1
1 3 2 2 2 2 2 1 2 2 2 2 3 2 2 2 2 2 2 1
1 2 1 2 2 2 2 1 2 2 2 2 1 2 1 2 2 2 2 1
1 0 1 2 1 1 2 2 2 2 2 2 1 1 2 2 2 1 2 2
1 0 1 1 2 2 2 2 2 2 2 2 2 2 2 2 2 2 2 1
1 2 2 2 2 2 2 2 2 2 2 2 2 2 2 2 2 2 2 1
1 1 1 1 1 1 1 1 1 1 1 1 1 1 1 1 1 1 1 1
7 1